L
--------------------------------------------------------------------------------
| ! |             |      |                   |       |           @ | ! |       |
|   |   -------   |  |   |   -------------   |   |   |   -------   |   |       |
|   |   |    |       |   |   |           |   |   |       |     |   |   |       |
|   |   |  * |-------|   |   |     1     |   |   |-------|  *  |   |   |       |
|       |  * |       |   |   |           |   |   |       |  *  |   |   |       |
|-------|  * |   K   |   |   ------   -----  |   |   K   |  *  |-------|       |
|           *  |   |       |###    ***    ###|         * |     |               |
|   ------------------|   -----   |   |   -----   |------------------   |      |
|                     |           |   |           |                     |      |
|   ---------------   |   ---------   ---------   |   ---------------   |      |
|   |             |   |   |                   |   |   |             |   |      |
|   |      \      |   |   |         2         |   |          ?      |   |      |
|   |                 |                       |   |   |             |   |      |
|   ---------------   |   ---------------------   |   ---------------   |      |
|                     |             \             |                     |      |
|   ------------------|   ---------------------   |------------------   |      |
|   |                 |                       |   |                     |      |
|           ?         |   |         K         |   |        \        |   |      |
|   -------------------   ---------------------   -------------------   |      |
|                                 8  ?                                  |      |
--------------------------------------------------------------------------------
