L
-------------------------------------1------------------------------------------
|                                                                              |
|   @   |                                                              |   @   |
|   @   | * * * * * * * * * * * * * * * * * * * * * * * * * * * * * *  |   @   |
|   @   | * * * * * * * * * * * * * * * * * * * * * * * * * * * * * *  |   @   |
|   @   | * * * * * * * * * * * * * * * * * * * * * * * * * * * * * *  |   @   |
|   @   | * * * * * * * * * * * * * * * * * * * * * * * * * * * * * *  |   @   |
|   @   | * * * * * * * * * * * * * * * * * * * * * * * * * * * * * *  |   @   |
|   @   | * * * * * * * * * * * * * * * * * * * * * * * * * * * * * *  |   @   |
|   @   | * * * * * * * * * * * * * * 9 ? * * * * * * * * * * * * * *  |   @   |
|   @   | * * * * * * * * * * * * * * * * * * * * * * * * * * * * * *  |   @   |
|   @   | * * * * * * * * * * * * * * * * * * * * * * * * * * * * * *  |   @   |
|   @   | * * * * * * * * * * * * * * * * * * * * * * * * * * * * * *  |   @   |
|   @   | * * * * * * * * * * * * * * * * * * * * * * * * * * * * * *  |   @   |
|   @   | * * * * * * * * * * * * * * * * * * * * * * * * * * * * * *  |   @   |
|   @   | * * * * * * * * * * * * * * * * * * * * * * * * * * * * * *  |   @   |
|   @   |                                                              |   @   |
|   @   |                                                              |   @   |
|   @   |                                                              |   @   |
--------------------------------------------------------------------------------